7	7	5	4	#	6	3	#	8	3
5	4	8	9	7	3	8	6	9	7
#	8	2	7	9	9	5	1	6	5
#	7	#	1	7	8	8	5	8	8
S	8	2	#	8	5	8	8	4	#
3	7	8	3	2	#	6	3	2	1
2	8	#	#	5	4	4	9	6	4
1	#	1	5	#	8	8	9	4	#
2	8	8	6	G	#	6	8	1	4
3	3	8	6	5	4	1	#	6	#
