1	#	5	8	5	6	3	#	#	4
5	3	1	7	2	#	6	7	6	2
4	1	4	8	5	1	#	6	2	#
4	7	4	9	8	9	2	7	4	4
8	8	1	9	8	6	4	8	1	S
7	5	7	5	1	6	#	3	3	4
3	8	#	3	9	4	#	5	5	9
7	#	9	3	6	3	3	6	7	5
4	5	6	3	2	G	3	3	#	8
5	6	#	8	7	7	4	4	#	#
