4	9	2	1	8	6	9	8	4	4
6	5	7	5	9	6	3	7	5	2
6	1	1	9	4	9	2	5	2	9
#	1	6	7	9	#	3	7	4	G
4	3	2	1	6	#	5	8	3	4
6	7	2	7	6	2	2	8	6	8
7	4	3	3	#	#	7	1	5	S
4	5	1	#	7	1	5	#	2	9
9	6	2	1	2	1	5	8	8	2
5	7	9	4	3	4	9	4	5	8
