3	6	1	7	1	8	7	8	6	6
4	5	8	3	3	2	#	5	7	9
6	#	9	3	3	8	5	1	7	5
S	#	7	3	6	8	9	7	2	8
8	3	#	4	5	8	1	8	9	#
4	9	4	3	8	5	5	1	1	9
7	5	7	1	#	9	5	1	#	9
5	8	5	6	#	5	8	3	6	9
7	9	1	6	#	1	5	G	3	5
#	#	3	8	5	#	5	7	9	4
