#	7	7	#	5	1	5	9	6	2
3	4	1	7	6	7	1	2	8	8
4	3	9	5	7	8	6	4	4	2
5	#	2	3	2	4	6	1	2	4
2	8	6	7	8	#	2	5	#	4
1	7	3	8	7	G	4	#	7	6
6	2	#	6	3	S	#	7	7	#
3	2	6	2	3	#	5	#	6	#
3	9	7	8	1	#	7	3	2	7
1	6	8	8	3	1	5	4	3	7
